NO Images/north.xpm
SO Images/south.xpm
WE Images/west.xpm
EA Images/east.xpm

F 43,29,114
C 106,79,240



111111111111111111111111111111111111111111111111111111111
1E0000000000000000000000000000000000000000000000000000001
111111111111111111111111111111111111111111111111111111111