NO Images/north.xpm
SO Images/south.xpm
WE Images/west.xpm
EA Images/east.xpm
F 43,29,114
C 106,79,






        1111111111111111111111111
        1                  101  1
        1111111111111111111111111
        1000000000110000000000001
        1111111111111111111111111111111
        10000000011111     100000000001111
        10110000011111  1  110000000001111
        10110000011111     110000000001111
        100100000011111111110000111111
111111111011000011100000000000011
100000000011000001110111111111111
1111011111111101D100000010001
11110111111E000D0001010010001
11010100110101011100000010001
10000000000000001100000100111
10000000000000001101010010001
1100000111010101111101111000111111
11110111 1110101 101111010001
11111111 1111111 11111110111
  1111     1111      11111
