11111111111111111
1001100P0000100C1
1C000000100000011
10C00001100000111
100T010000000E111
11111111111111111