111111111111
1P0C0000T0E1
111111111111