111111111111111
1E000T000000001
11111C1111110C1
11011011111C001
110110000000001
100111111P00C01
1T00T0C0000C001
111111111111111