1111111111
1P000E1011
11100P0C01
1C00011111
1111111111