1111111111
1PCE11001
1111111111