11111111111111111
100T100P0000100C1
1C0000001000000E1
10C00T011000C0001
11111111111111111