1111111111
1P0C0T0001
1T0T00C0E1
1111111111