111111111111111
1E000T000000001
11111C1111110C1
11111011111C001
111110000000001
111111111P00C01
1T0000C0000C001
111111111111111