1111111111
1PCE11111
111111111