1111111111
1E00C0C0P1
1111111111